// $at
0000_000A
// $v0-$v1
0000_0003
0000_0000
// $a0-$a3
0000_0000
0000_00D4
0000_0006
0000_0007
// $t0-$t7
0000_0008
0000_0009
0000_0010
0000_0011
0000_0012
0000_0013
0000_0014
0000_0015
// $s0-$s7
0000_0001
0000_0002
0000_0003
0000_0004
0000_0005
0000_0006
0000_0007
0000_0008
// $t8-$t9
0000_0024
0000_0025
// $k0-$k1
0000_0026
0000_0027
// $gp
0000_0028
// $sp
0000_0029
// $fp
0000_0030
// $ra
0000_0031


